-------------
|    x      |
|           |
|--------- -|
|         o |
|o       J  |
|x        | |
|-------- --|
|           |
|   o       |
|x|         |
-------------
