-------------------------------
|    x                        |
|                        |    |
|-------------------------    |
|                             |
|o             Jo   |         |
|x             -    |         |
|--------------------         |
|                             |
|                             |
| | o                         |
|x|                           |
-------------------------------
